2 550 890 550 1 
000 000 000 000 000 000 000 000 000 000 000 000 000 000 000 000 000 000 000 000 000 000 000 000 000 000 000 000 000 000 000 000 000 000 000 000 000 000 000 000  
000 000 000 000 000 000 000 000 000 000 000 000 000 000 000 000 000 000 000 000 000 000 000 000 000 000 000 000 000 000 000 000 000 000 000 000 000 000 000 000 
000 000 000 000 000 000 000 000 000 000 000 000 000 000 000 000 000 000 000 000 000 000 000 000 000 000 000 000 000 000 000 000 000 000 000 000 000 000 000 000 
000 000 000 000 000 000 000 000 000 000 000 000 000 000 000 000 000 000 000 000 000 000 000 000 000 000 000 000 000 000 000 000 000 000 000 000 000 000 000 000 
000 000 000 000 000 000 000 000 000 000 000 000 000 000 000 000 000 000 000 000 000 000 000 000 000 000 000 000 000 000 000 000 000 000 000 000 000 000 000 000 
000 000 000 000 000 000 021 021 000 000 000 000 000 021 021 000 000 000 000 000 000 000 000 000 000 000 000 000 000 000 000 000 000 000 000 000 000 000 000 000 
000 000 000 000 000 000 049 049 000 000 000 000 000 049 049 000 000 000 000 000 000 000 000 000 000 000 000 000 000 000 014 015 016 000 000 000 000 000 000 000 
000 000 000 000 000 000 000 000 000 000 000 021 000 000 000 000 000 000 021 000 000 000 000 000 000 000 000 000 000 000 042 043 044 021 000 000 000 000 000 000 
000 000 000 000 000 000 000 000 000 000 000 049 000 000 000 000 000 000 049 000 000 000 000 000 000 000 000 000 000 000 000 000 000 049 000 000 000 000 000 000 
000 000 000 000 000 000 000 000 000 000 000 000 000 000 000 000 000 000 000 000 000 000 000 000 014 015 016 000 000 000 000 000 000 000 000 000 000 000 000 000 
000 000 000 000 000 000 000 000 000 000 000 000 000 000 000 000 000 000 000 000 000 000 000 000 042 043 044 000 000 000 000 000 000 000 000 000 000 000 000 000 
000 000 000 000 000 014 015 015 016 000 000 000 000 000 000 000 000 014 015 016 000 000 000 000 000 000 000 000 000 000 000 000 000 000 000 000 014 015 016 000
000 000 000 000 000 042 043 043 044 000 000 000 000 000 000 000 000 042 043 044 000 000 000 000 000 000 000 000 000 000 000 000 000 000 000 000 042 043 044 000
000 000 000 000 000 000 000 000 000 000 000 000 000 000 000 000 000 000 000 000 000 000 000 000 000 000 000 000 000 000 000 000 000 000 000 000 000 000 000 000 
000 000 000 000 000 000 000 000 000 000 000 000 000 021 000 000 000 000 000 000 000 000 000 000 000 000 000 000 000 000 000 014 015 016 000 000 000 000 000 000 
000 000 000 000 000 000 000 000 000 021 000 000 000 049 000 000 000 000 000 000 000 021 000 000 000 000 000 000 000 000 000 042 043 044 000 000 000 000 000 000
000 000 000 000 000 000 000 000 000 049 000 000 000 000 000 000 000 000 000 000 000 049 000 000 000 000 000 000 000 000 000 000 000 000 000 000 000 000 000 000
000 000 000 000 000 000 000 000 000 000 000 000 000 000 000 000 000 000 000 000 000 000 000 000 000 000 021 000 000 000 000 000 000 000 000 000 000 000 000 000 
000 000 000 000 000 000 000 000 000 000 000 000 000 000 000 000 000 000 000 000 000 000 000 000 000 000 049 000 000 000 000 000 000 000 000 000 000 000 000 000 
008 008 008 008 008 008 008 008 008 008 008 008 008 008 008 008 008 008 008 008 008 008 008 008 008 008 008 008 008 008 008 008 008 008 008 008 008 008 008 008 
035 035 035 035 035 035 035 035 035 035 035 035 035 035 035 035 035 035 035 035 035 035 035 035 035 035 035 035 035 035 035 035 035 035 035 035 035 035 035 035 
027 027 027 027 027 027 027 027 027 027 027 027 027 027 027 027 027 027 027 027 027 027 027 027 027 027 027 027 027 027 027 027 027 027 027 027 027 027 027 027 
027 027 027 027 027 027 027 027 027 027 027 027 027 027 027 027 027 027 027 027 027 027 027 027 027 027 027 027 027 027 027 027 027 027 027 027 027 027 027 027 												